'weld[wledw]
dwe;dwedl
dwe;dlwd
1111111111111
100000F000001
1000000000001
1000020000201
1000000000001
1000000000001
1000000000001
1000000000001
1000000000001
1000000000001
1000020000201
1000000000001
1000000000001
1000000000001
10000000N0001
1000000000001
1111111111111